{
    "grid_size": 5,
    "cells": [
        [0, 1, 0, 0, 0],
        [1, 1, 0, 1, 0],
        [0, 0, 0, 1, 0],
        [0, 0, 1, 1, 0],
        [0, 0, 0, 0, 0]
    ],
    "target": [
        [2, 2, 2, 2, 2],
        [2, 2, 2, 2, 2],
        [2, 2, 2, 2, 2],
        [2, 2, 2, 2, 2],
        [2, 2, 2, 2, 2]
    ]
}
